11111111111111111111111111
1001E000000C0000C0000C0001
10C0011111100000000000C001
10CC111000000000C0000C0001
1000000000C000C00100110001
100000C00000000C0110000001
10P0000010000C00000000C001
10000C00000000001000000001
10000C000C00000110C000C001
100000011100000C0000C00001
10000000000000000000000001
10000000C000100C0000C00001
10000C00100000000C0000C001
11111111111111111111111111