1111111111111
1001E000000C1
10C0011111P01
10CC111000001
1111111111111