1111111111111
1001000111000C1
1000011111000001
1P0011E000001
11111111