11111111111111111111111111
1E01C000000C0000C0000C0001
10C0011111100000000000C001
10CC111000000000C0000C0001
1000000000C000C00100110001
100000C00000000C0110000001
1P00000010000C00000000C001
11111111111111111111111111