111111111111
1000000001E1
100001111011
1111C0000C01
1000P0000001
111111111111